9,5,7,11,9,5,1,5,5,3
10,9,3,8,0,5,0,5,1,2
12,6,10,10,10,9,4,3,10,10
11,9,4,2,8,0,5,2,10,10
10,10,9,6,10,12,5,6,14,14
10,10,10,9,6,11,11,9,5,3
8,2,12,6,9,0,2,12,3,10
10,10,9,3,10,10,8,3,10,10
10,14,10,10,10,12,6,14,10,10
12,5,6,12,4,5,5,5,6,14
