11,11,9,3,9,5,3,9,5,3
12,4,6,12,4,5,0,2,13,6
9,5,3,9,1,1,6,8,5,3
12,5,0,6,10,8,1,2,9,2
13,3,8,1,4,2,10,10,10,10
11,12,0,4,1,4,4,6,14,14
12,3,12,1,4,5,5,5,1,7
11,12,1,6,9,3,11,9,4,3
8,3,8,5,6,12,0,6,9,6
14,12,4,5,5,7,12,7,12,7
