11,11,9,3,9,7,13,3,11,15
10,10,14,10,8,3,9,0,0,3
10,10,9,6,8,4,2,10,10,10
8,0,6,11,10,11,10,10,10,10
10,12,1,4,2,8,0,4,2,10
8,5,0,1,0,6,12,3,10,10
10,9,2,12,6,9,3,12,2,10
10,10,12,5,1,2,8,5,6,14
10,12,5,3,12,6,12,3,9,3
12,5,5,4,5,5,7,12,6,14
