9,3,11,9,3,9,7,11,9,7
10,8,2,10,12,0,1,4,4,3
12,2,8,4,1,6,8,5,3,10
11,10,8,5,4,5,0,7,12,2
8,4,4,5,3,11,14,9,3,14
8,1,1,5,6,8,1,6,8,3
10,10,12,3,9,6,10,11,10,10
8,6,11,10,10,13,2,10,10,10
10,11,10,14,8,5,4,6,10,14
12,4,4,5,4,5,5,7,12,7
